0	zero
1	one
2	two
3	three
4	four
5	five
6	six
7	seven
8	eight
9	nine
a	a
A	A
b	b
c	c
d	d
e	E
E	E
f	f
g	g
h	h
i	i
j	j
k	k
l	l
m	m
n	n
o	o
p	p
P	P
q	q
r	r
s	s
t	t
u	u
w	w
x	x
y	y
z	z
ö	ö
ऑ	A
ऐ	ai
ऍ	ae
Å	A
ख	kh
घ	gh
ङ	ng
ञ	ny
ट	T
ठ	Th
ड	D
ढ	Dh
ण	N
थ	th
ध	dh
प	p
फ	ph
ब	b
भ	bh
म	m
य	y
र	r
ल	l
ळ	L
व	v
श	sh
ष	Sh
स	s
ह	h
क	k
ऋ	R
@	æ
φ	ऴ
ŋ	ं
ŧ	त
λ	e